###################
#     ########### #
#B    ###         #
#     ### ####### #
# ####### ## ##   #
#     ### ## ## # #
##### ###    ## # #
##### ######### # #
#               # #
# ############# # #
# #########     ###
#A#################